                          
                            1
         1111111111  _      1
        _1 p  11111__ _ _ _ 1
      11  p1  11111n _ _ _ _1
        111  111111__ _ _ _ 1    
K *  11p  P 1111111_ _____ N1     
1111111111111111111 _1111 111   11111111
                  11  1111111  11 111111
                  111         11  11
                  1111111111111   111111