

       1 1 1 1 1
       111111111
       1     111
       1   Qk111
K r *      11111
1111111111111111


over 3, up 1