



         111111   1111111111
         111111   1111111111            
K *      111111   1111111111             
11111111 111111   1111111111   11111111111           
11111111 ______   __________  1111111
11P                    R R   11111111
1111111111111111111111111111111111111